1111111111111
110000000C001
11000C0000001
11P0000000001
1111111111111