1111111111110
110000000E001
1100000000001
11P0000000001
1111111111111