1111111111111
11000C000E001

11P0000000001
1111111111111