1111111111111
110000010E001
1100C01C10001
11P0000100001
1111111111111