1111111111111
110100000E001
111P1000C0001
1110100000001
1111111111111