1111111111111
110000000E001
110000C000001
11P0000000001
1111111111111
