11111111
10010E01
11000011
11111111