11111111111
111000000011
100000000001
1111111111111