1111111111111
11000X000E001
11C0000000001
11P000P000001
1111111111111