1111111111111
110000000C001
1100C01110001
11P0001010001
1000001E10001
1111111111111